0 0 0 0 0 0 0 0 0 0 0 0 0 0 0 3
0 4 5 6 0 0 0 0 0 0 0 0 0 0 0 3
0 7 8 9 0 0 0 0 0 0 0 0 0 0 0 3
0 10 11 12 0 0 0 0 0 0 0 0 0 0 0 3
0 0 0 0 0 0 0 0 0 0 0 0 0 0 0 3
0 0 0 0 0 0 0 0 0 0 0 0 0 0 0 3
0 0 0 0 0 0 0 0 0 0 0 0 3 3 3 3
0 0 0 0 0 0 0 0 0 3 3 3 3 2 2 2
0 0 0 0 0 0 0 3 3 2 2 2 2 2 2 2
0 0 0 0 0 0 0 3 2 2 2 2 2 2 2 2
0 0 0 0 0 0 0 3 2 2 2 2 2 2 2 2
3 3 3 3 3 3 3 3 2 2 2 2 2 2 2 2